111111111111111111111
102000200020002000201
100020002000200020001
102000200020002000201
100020002000200020001
102000200020002000201
100020002000200020001
102000200020002000201
100020002000200020001
102000200020002000201
100020002000200020001
102000200020002000201
100020002000200020001
102000200020002000201
100020002000200020001
102000200020002000201
100020002000200020001
102000200020002000201
100020002000200020001
111111111111111111111